nevar : neiger
palabrota : gros mot
actuacion : intervention, agissement
calcetin : chaussette
comodo : confortable
pillarse por alguien : flasher sur quelqu'un
bicho raro : drôle d'oiseau
sello : timbre
sello : cachet, tampon
cabrear : énerver, foutre en rogne
enfadar : agacer, énerver, fâcher
aburrir : ennuyer
divertido : amusant, drôle
vistazo : coup d'oeil
opuesto : opposé
aborrecer : détester, haïr
envidia : envie, jalousie
celos : jalousie
apartarse : s'éloigner, s'écarter
obvio : évident
trastorno : dérangement, désagrément
ocurrir : arriver, avoir lieu
nineria : enfantillage
practicar : s'entraîner
herramienta : outil
reventar : éclater, crever
tumbarse : s'allonger
tumbar : mettre par terre, renverser
nublado : nuageux
tapar : couvrir
pedo : beuverie, cuite
bobada : bêtise, sottise
asumir : assumer
coquetear : flirter, draguer
rebelde : rebelle
ilusionado : enthousiaste
alcanzar : atteindre
alto al fuega : cessez-le-feu
lograr : réussir à, parvenir à
hacienda : exploitation, propriété
hacienda : fortune
pederasta : pédophile
destacar : ressortir, se démarquer
renir : gronder, se disputer
cruz roja : croix-rouge
falsedad : fausseté, mensonge
rebasar : dépasser
plusmarca : nouveau record
pantalla : écran
disfraz : déguisement