apartar : déplacer, écarter, mettre de côté
sargento : sergent
reincidente : récidiviste
chivato : mouchard, délateur
celda : cellule
atascar : boucher
desague : tuyau d'écoulement
lamer : lécher
achicar : rétrécir
promedio : moyenne
decantarse : opter pour, choisir
regir : régir, gouverner, diriger
retraer : dissuader de faire quelque chose, se rétracter, se retirer
asado : rôti
matambre : paupiette
falda : hampe
vacio : tranche de boeuf
acopiar : accumuler
cepo : piège
cumbre : sommet
pocilga : porcherie
criar : nourrir, alimenter
criar : élever
criado : domestique
criado : élevé
matadero : abattoir
tremendo : horrible, terrible, énorme, gigantesque
audaz : audacieux
inversion : investissement
inversion : inversion, permutation
chiquito : minuscule, tout petit
rebote : rebond
agarrar : attraper, saisir, prendre
subvencion : subvention
hurtar : voler, dérober
prepotente : abusif, injuste
ajeno : autrui
ajeno a algo : étranger à, extérieur à
opaco : opaque
vara : bâton
entregar : remettre, livrer
desplegar : déplier, déployer
adiestrar : entraîner, former
recorrido : parcours, itinéraire
emboscada : embuscade, guet-apens
compromiso : accord
compromiso : situation délicate, embarras
soberania : souveraineté
lazo : lien
estrechar : rapprocher, resserer, renforcer