almacen : entrepôt, magasin, réserve
lancha : cannot à moteur, zodiac
entumecido : engourdi
rumbo : direction
rescatar : sauver
tienda de campana : tente
acampar : camper
campista : campeur
repunte : hausse
prevalecer : prospérer, perdurer, prévaloir
agobiar : déranger, incommoder
estacional : de saison 
sofocar : éteindre
huir : fuir
desplazado : déplacé, réfugié
hoguera : bûcher
manta : couverture
impedir : empêcher
reapertura : réouverture
perjudicar : nuire à
endurecer : durcir
alcanzar : atteindre
parto : accouchement
salvaje : sauvage
empujar : pousser
traicionar : trahir
chivarse : cafter, moucharder
cucaracha : cafard
rebotar : rebondir
chivato : mouchard, délateur
atreverse : oser
punalada : coup de couteau
fiscalia : bureau du procureur, parquet, ministère public
recluso : prisonnier
fregona : serpillière
humo : fumée
ambiante libre de humo : espace non-fumeur
helado : glace
helado : gelé
camilla : brancard, civière
avaricia : avarice
silueta : silhouette
escombro : décombres, débris
pringado : pauvre type, couillon
averiguar : découvrir, trouver, chercher à savoir
regordete : rondelet, grassouillet
revolcon : baise, partie de jambes en l'air
apostar : parier
corredor de apuestas : bookmaker
corredor : coureur