mote : surnom
redil : enclos
cocinero : cuisinier
fregar : laver
acogedor : accueillant
reventar : éclater, crever
agarrar : attraper, prendre
perezoso : paresseux
escoba : balai
escobar : balayer
trapeador : serpillière
esponja : éponge
armario : armoire
carton : carton
placa : plaque
tarjeta : carte
pegar oro : fermer l'oeil
nieto : petit-fils
opinar : penser, donner son avis
retrasar : retarder
telon : toile
mezcla : mélange
discurso : discours
cojin : coussin
chupar : sucer
ternura : tendresse
pecado : péché
comprobar : vérifier
traspié : faux-pas, trébucher
topetar : percuter
incautar: saisir, confisquer
chaleco antibalas : gilet pare-balles
chaleco salvavidas : gilet de sauvetage
aprobar : réussir, admettre à un examen
aprobar : approuver
atar : lier
soplon : mouchard, indicateur
caluroso : chaud
calabozo : cellule, cachot
redada : descente de police
afligido : triste, affligé
atormentar : torturer
atormentar : tourmenter
autodesprecio : dégoût de soi
huida : fuite
plagado : rempli, truffé
plagar : remplir de, couvrir de
cementerio : cimetière
vela :bougie
ensanarse : s'acharner