engreido : prétentieux
crujir : craquer, crisser, grincer
arrugar : froisser, chiffonner
pachucho : patraque, malade
majo : sympa, gentil
polvora : colérique, avoir le sang chaud
arpia : femme vénale
alfombra : tapis
oficio : métier
largarse : se tirer, se barrer
rellenar : remplir
cubo de la basura : poubelle
sombra : ombre
escopeta : fusil
gaga : personne âgée gaga
plegaria : prière
gasto : dépense
gasto : entretien
fastidiar : ennuyer, fatiguer, énerver
carrito : poussette
tiroteo : fusillade
agobiar : déranger, incommoder
asustar : effrayer
molestar : déranger
cachas : musclé, bien foutu
establecer : établir
ingreso : revenus
ingreso : entrée
ingreso : dépôt, versement
inversor : investisseur
banador : maillot de bain
cochino : cochon, porc, dégueulasse
remar : ramer
laguna : trou de mémoire
pillar : attraper, choper (grippe, rhume)
vestido : robe
despegue : décollage
engreirse : s'enorgueillir, prendre la grosse tête
despegar : décollage
pantalon : pantalon
camisa : chemise
calcetin : chaussette
zapato : chaussure
cordon : lacet
pintalabios : rouge à lèvres
pommada : pomade
peigne : peine
anillo : bague
collar : collier
gafas : lunettes