colchon : matelas
mojar : mouiller
peculiar : étrange, bizarre
hogar : foyer, intérieur
vivienda : logement
bruja : sorcière
trasladar : déplacer, déménager
obispo : évêque
atravesar : traverser
higuera : figuier
llovizna : bruine
tierno : tendre
cagada : merde
salpicar : éclabousser
pajaro : oiseau
pormenor : détail
los pormenores de : les tenants et aboutissants
ingrato : ingrat
papel de estano : papier alluminium
tropezar : trébucher
tropezar con : trébucher sur, se cogner contre
almendro : amandier
certero : précis
ajeno : d'autrui
sueno : rêve, sommeil
ayunar : jeûner
advertir : prévenir, advertir
agurio : augure, présage
aciago : funeste
preceder : précéder
presagio : présage
ropa : vêtements
paladar : palais (bouche)
resaca : gueule de bois
aliento : haleine
sedimento : dépôt, résidu
parranda : fête, bringue
estragos : ravages, blessures
boda : mariage
destazar : découper, dépecer
sonoliento : somnolent
comentar : raconter, expliquer, commenter
platanal : bananier
turbio : trouble
bajo : bas
desgracia : malheur
menudo : mineur, peu importante
reponerse : se remettre
regazo : giron
campana : campagne, cloche