tranca : barre, bâton
muelle : quai
prevenir : prévenir
alcanzar : atteindre
apartarse : s'éloigner, s'écarter
almendro : amandier
alboroto : vacarme, boucan
gallo : coq
guirnalda : guirlande
rama : branche
detergente : lessive
acosar : harceler
ajedrez : échec
peon : pion
resbalar : glisser
fastidiar : embêter, emmerder
fastidiar : faire capoter, gâcher
machacar : blesser, faire mal
coronar : couronner
aplastar : écraser, aplatir
cuerno : corne
piedad : pitié
chungo : nul, pourri
trapichear : magouiller, trafiquer
pendiente : en suspens, en cours
bocazas : bavard, pipelette
rastro : trace
aguantar : supporter
guaperas : pin-up
panal : couche
pedo : cuite
agarrar : attraper, prendre
menudo plan : bon plan
estibador : docker
chusma : racaille
redondo : rond
chisme : truc
sermonear : sermonner, réprimander, faire la leçon, faire la morale
trena : taule, trou, placard, gnouf
cabrear : énerver, foutre en rogne
procesar : poursuivre, intenter un procès
fontanero : plombier
pavo : type, mec
pava : meuf
asesoria : conseil
techo : toit
tarado : taré
arrebato : emportement, accès de folie
aludir : évoquer, faire allusion à
hundir : faire couler, faire s'effondrer