abridor : ouvre-boîte, ouvre-bouteille
reloj : montre
soplar : souffler
agarrar : attraper, prendre, saisir
colarse : s'infilrer, s'incruster
partido : match
camiseta : t-shirt
capricho : caprice
caprichoso : capricieux
conceder : accorder, concéder
peculiar : étrange, bizarre, particulier
basca : bande de potes
vasco : basque
regentar : diriger, tenir, être à la tête
crecida : crue
calderilla : petite monnaie
table : planche
pendiente : en cours, en suspens
ahorrar : économiser
enarcar : froncer
atar : attacher
desprender : détacher, décoller
cortina : rideau
aguantar : supporter
compromiso : embarras, situation délicate
prestamo : prêt
prestador : prêteur
acreedor : créditeur
pego : tricherie, triche
una : ongle
agarrarse : s'accrocher, se tenir à
polvo : baise
polvo : poussière
enhorabuena : félicitation
traspasar : transférer, déplacer
transferir : transférer
trasladar : déplacer, déménager, 
trasladar : déplacer, reporter
reformar : rénover, refaire
ligoteo : draguer
ligarse a alguien : draguer
careto : visage, tronche, gueule
desatascar : débloquer, déboucher
prever : prévoir
traspaso : cession, transfert
ajuste : réglage, ajustement
reto : défi
arrastrar : traîner
costal : sac
cochera : garage