apretar : serrer, presser
gatillo : gâchette
discutir : se disputer
extrarradio : banlieue, périphérie
anicos : en mille morceaux, en miettes
remolino : tourbillon
horrendo : horrible, moche
enredarse en : se mêler
martillo : marteau
turista : touriste
anhelo : désir, aspiration
roncar : ronfler
seso : cervelle, cerveau
cerebro : cerveau
lastre : obstacle, handicap
rinon : rein
aplastamiento : écrasement
aplastar : écraser
pajaro : oiseau
pellejo : peau (animal)
empujar : pousser
enganchar : accrocher
flujo : flux
coser : coudre
ternera : veau
manitas : bricoleur, bricoleuse
rezar : prier
traidor : traitre
mando : télécommande
quiebra : effondrement, faillite
arena : sable
panuelo : mouchoir
tarado : taré, dingue
ladrar : aboyer
incautar : saisir, confisquer
portatil : portable, oridinateur portable
estancia : séjour
agacharse : se baisser, s'accroupir
tantear : sonder, tâter
sacudir : agiter, secouer, remuer
sarten : poêle
cazuela : casserole
el cazo : la casserole
foco : projecteur
soplon : mouchard, balance
herencia : héritage
resaca : gueule de bois
cortina : rideau
cable : câble
la medicina : le médicament