rechazar : refuser
sargento : sergent
ejercito : armée
ascender : monter en grade / être promu
subteniente : sous-lieutenant
al amparo de : à l'aide de
notificar : notifier
auto : jugement / décision
perseguir : poursuivre
solicitud : demande
encargado : responsable / gérant
velar : veiller
velar por : veiller sur
llevar a cabo : mener à bien
diligencia : formalité administrative
agregar : ajouter
referir : faire référence
solicitante : demandeur / candidat
indistintamente : indifféremment
quirurgico : chirurgical
tardar : être en retard / mettre du temps
recurso : recours / appel / pourvoi
por consiguiente : par conséquent
enfatizar : mettre l'accent sur
fraudulento : frauduleux
ordenamiente : ordre / réglementation
sometimiento : soumission
recordar : rappeler
sospechar : soupçonner
dar a luz : donner naissance
tomar medidas : prendre des mesures
descartar : écarter / éliminer
incumplimiento : non-respect
libra : livre setrling
portavoz : porte-paraole
congeniar : s'entendre avec / sympathiser
no obstante : néanmoins / cependant
entrevista : entretien
agotar : épuiser / exténuer
odio : haine
delito : délit / crime
sede : siège
acudir : se rendre à
presenciar : assister à
inmediaciones : abords / environs / alentours
hincha : supporter
aficionado : supporter
hombro : épaule
increpar : interpeller
detalle : détail