homenaje : hommage
coro : choeur
extranar : manquer à
extranar : surprendre
tarea : tâche, travail
temor : crainte, peur
estupefaciente : stupéfiant
temprano : tôt
orden : ordre
entrono : environnement
emprender : entreprendre
rumbo : direction
asentarse : se stabiliser, s'installer
mesero : serveur
desalentar : décourager
alentar : encourager
animar : encourager
sidreria : cidrerie
fallido : raté
estafa : escroquerie, arnaque
seno : sein
criar : élever
bachillerato : bac, baccalauréat
alborotador : perturbateur
sede : siège
nomina : paie, salaire
estafar : arnaquer
cobrar : toucher, encaisser
despegue : lancement, commencement, démarrage
despegar : décoller
impulsar : propulser
fabada : cassoulet asturien
resena : compte rendu, critique
aflorar : émerger
revés : revers, déception, déboire
matrimonio : mariage
relanzar : relancer
alarde : étalage, ostentation, exhibition
traspaso : prix de vente
guardaespaldas : garde du corps
escolta : garde du corps
franquisia : franchise
deslumbrar : éblouir
belleza : beauté
cortejar : courtiser
alardear : se vanter, fanfaronner
agraciado : gracieux
estatura : taille
laboral : professionnel
agradar : plaire