acopio : approvisionnement
forcejeo : lutte
medida : mesure
no obstante : cependant
rezagar : traîner, être à la traîne
censo : recensement
villano : mauvais, vil
entrega : livraison, remise
entrada : entrée
cotilla : commère
ermitano : ermite
precavido : prévoyant
prever : prévoir
intuicion : intuition, pressentiment
carga : poids, fardeau
tapadera : couverture
despitarse : être distrait, se déconcentrer
atleta : athlète
policiaco : policier
embarcarse : embarquer, monter à bord
a rastras : a contrecoeur
crio : enfant, gamin
cria : petit (animaux)
atun : thon
entierro : enterrement
ataud : cercueil
floristeria : fleuriste
desnortar : désorienter
adentrarse : s'enfoncer
investigacion : enquête
destacar : ressortir, se démarquer
acojonarse : avoir peur
acojonar : faire peur à
sartén : poêle
cazo : casserole
cazuela : casserole
cacerola : casserole
brazalete : bracelet
pulsera : bracelet
collar : collier
alcancia : tirelire
envidiar : jalouser, envier
bambino : gamin, enfant
guata : ventre, bide
vientre : ventre
estomago : estomac
perseguir : poursuivre
troca : pick-up
espejo : miroir
vidrio : vitre