hielo : glace (eau congelée)
helado : glace
finura : finesse
anhelo : désir
andar : marcher
tumbar : renverser, mettre par terre
toma electrica : prise électrique
enchufar : brancher
ternero : veau
becero : veau
gallina : poule
pollo : poulet
cepillo de dientes : brosse à dents
cordon : lacet
apostar : parier
acelerar : accélérer
gritar : crier
aullar : hurler
cala : crique
cimientos : fondations
sabana : drap
bombilla : ampoule (éclairage)
ampolla : ampoule (peau)
pulgar : pouce
dedo grande : pouce (pied)
chupar : sucer, aspirer
vaso : verre (pour boire)
jarra : pichet
indice : sommaire
somera : sommaire
barco : bateau
cesped : pelouse
farol : lampadaire
banco : banc
sofa : canapé
camion : camion
tecla : touche (clavier)
teclado : clavier
costarle a alguien : avoir du mal
costar : coûter
neumatico : pneu
motor : moteur
parabrisas : pare-brise
raiz : racine
favorito : favori
funda : taie
escritor : écrivain
pluma : stylo
lapiz : crayon
dibujar : dessiner