desmayar : faiblir
desmayarse : s'évanouir
eterno : éternel
aldaba : heurtoir, loquet, verrou
sobresaliente : très bien
esquina : coin
madrena : sabot
jinete : cavalier
rayar : rayer, se lever, au petit jour
anochecer : tombée de la nuit
acosar : traquer, poursuivre, harceler
ladrido : aboiement
atar : attacher
alba : aube, levée du jour
lontananza : lointain
velada : voilée
loma : colline
terreno : terrain
yermo : terre en friche, désert
oveja : mouton
rebano : troupeau
recua : bêtes de charge, queue de personnes
sudario : linceul
mujeriego : don juan, coureur de jupons, homme à femmes
rocin : canasson, cheval de travail
postrero : dernier
arriero : muletier
monte : mont, colline
falda : jupe
falda : flanc
pradera : prairie
alla : là-bas
alla : autrefois, jadis
dominio : pouvoir, domination
dominio : domaine, territoires
pazo : maison de campagne
feudo : fief
hilar : relier, établir un lien
concebir : concevoir
pecado : péché
trebedes : trépied
vaciar : vider
alfoja : sacoche
servilleta : serviette de table
cortina : rideau
cenicienta : cendré, noir
rafaga : rafale
yantar : déjeuner
maldad : méchanceté
pareza : paresse