coraje : courage
rematar : achever
fiscalia : ministère public, parquet, bureau du procureur
una : ongle
logro : succès, réussite
herencia : héritage
emprendimiento : entreprise, entrepreneuriat
rebote : ricochet, rebond
seudo : pseudo
morbo : curiosité malsaine, curiosité morbide
lacra : fléau
extranar : manquer à
extranar : surprendre
lujo : luxe
paradero : lieu, endroit
cortina : rideau
balacera : fusillade
aduenar : s'emparer de
cabecilla : leader, meneur
atar : attacher
fastidiar : fatiguer, ennuyer, embêter
borde : rustre, malpoli
acoger : accueillir, recevoir
rehen : otage
alojar : héberger, loger
rebano : troupeau
realeza : royauté, trône
chocho : gâteux
timar : escroquer, arnaquer
parado : debout
parado : être au chômage
derogar : abolir, abroger
aportar : contribuer, cotiser
patan : rustre, malotru, goujat
senado : sénat
apanar : réparer, réfistoler
retomar : reprendre
rechazar : rejeter
perjudicar : nuire à
mudarse : déménager
batido : milk-shake
acribillar : cribler de balle
ampliar : augmenter
balazo : coup de feu
pendiente : en suspens, en cours
anada : année
carabinero : douanier
sustraer : enlever, soustraire
fiscal : procureur
fiscal : inspecteur